Year,Incoming Calls,Answered Calls,Abandoned Calls,Answer Speed (AVG),Talk Duration (AVG),Waiting Time (AVG),Service Level (20 Seconds) AVG
2017,217,204,13,0:00:17,0:02:14,0:02:45,0.7628
2017,200,182,18,0:00:20,0:02:22,0:06:55,0.7273
2017,216,198,18,0:00:18,0:02:38,0:03:50,0.743
2017,155,145,10,0:00:15,0:02:29,0:03:12,0.7961
2017,37,37,0,0:00:03,0:02:06,0:00:35,0.973
2017,315,304,11,0:00:18,0:01:35,0:02:37,0.7717
2017,252,244,8,0:00:13,0:01:50,0:02:02,0.82
2017,213,205,8,0:00:10,0:02:10,0:03:22,0.881
2017,219,200,19,0:00:15,0:02:18,0:06:12,0.7945
2017,371,348,23,0:00:19,0:01:40,0:03:29,0.7363
2017,166,164,2,0:00:12,0:02:10,0:02:46,0.8133
2017,32,32,0,0:00:02,0:02:03,0:00:03,1
2017,231,222,9,0:00:08,0:01:49,0:02:18,0.8646
2017,205,197,8,0:00:07,0:01:52,0:02:48,0.9261
2017,338,313,25,0:00:13,0:01:51,0:03:40,0.8006
2017,180,174,6,0:00:13,0:02:18,0:03:26,0.838
2017,226,211,15,0:00:20,0:02:04,0:04:53,0.7623
2017,226,212,14,0:00:10,0:02:03,0:02:45,0.8444
2017,45,44,1,0:00:02,0:02:04,0:00:55,0.9778
2017,218,194,24,0:00:26,0:02:43,0:06:28,0.6898
2017,187,174,13,0:00:15,0:02:16,0:04:39,0.8152
2017,191,184,7,0:00:10,0:02:09,0:03:40,0.8564
2017,188,174,14,0:00:15,0:02:25,0:03:09,0.7688
2017,154,148,6,0:00:10,0:02:27,0:03:36,0.8506
2017,166,150,16,0:00:18,0:02:26,0:04:38,0.7683
2017,58,57,1,0:00:04,0:02:26,0:00:58,0.9483
2017,160,153,7,0:00:10,0:02:23,0:02:45,0.8491
2017,86,79,7,0:00:32,0:02:43,0:04:40,0.6163
2017,180,170,10,0:00:23,0:02:31,0:05:45,0.7753
2017,210,192,18,0:00:26,0:02:16,0:05:35,0.6746
2017,163,157,6,0:00:14,0:02:19,0:02:55,0.8137
2017,143,140,3,0:00:15,0:02:20,0:04:43,0.8252
2017,57,55,2,0:00:06,0:02:03,0:01:50,0.9123
2017,179,172,7,0:00:13,0:02:17,0:03:23,0.8249
2017,194,184,10,0:00:24,0:02:24,0:03:19,0.701
2017,201,196,5,0:00:15,0:02:16,0:04:53,0.8159
2017,218,189,29,0:00:32,0:02:37,0:08:04,0.5741
2017,194,190,4,0:00:16,0:02:22,0:02:02,0.8177
2017,227,219,8,0:00:15,0:02:44,0:03:55,0.8363
2017,52,52,0,0:00:09,0:02:16,0:00:52,0.9423
2017,385,370,15,0:00:20,0:02:11,0:03:10,0.7619
2017,137,130,7,0:00:16,0:02:26,0:09:47,0.7591
2017,254,252,2,0:00:10,0:02:08,0:01:10,0.9134
2017,211,206,5,0:00:11,0:02:24,0:04:37,0.8714
2017,282,279,3,0:00:07,0:02:18,0:01:11,0.9321
2017,262,260,2,0:00:08,0:02:31,0:01:13,0.908
2017,65,63,2,0:00:12,0:02:22,0:02:10,0.8594
2017,325,323,2,0:00:05,0:02:13,0:01:14,0.969
2017,235,230,5,0:00:05,0:02:19,0:00:58,0.9614
2017,215,212,3,0:00:05,0:02:14,0:00:58,0.9581
2017,85,85,0,0:00:03,0:02:26,0:00:55,0.9765
2017,195,195,0,0:00:05,0:02:24,0:02:13,0.9744
2017,188,182,6,0:00:15,0:02:14,0:01:51,0.8361
2017,58,58,0,0:00:06,0:02:22,0:00:52,0.9483
2017,251,247,4,0:00:14,0:02:16,0:01:53,0.8353
2017,181,178,3,0:00:12,0:02:24,0:01:57,0.8619
2017,228,213,15,0:00:26,0:02:16,0:03:07,0.6356
2017,165,163,2,0:00:09,0:02:25,0:02:20,0.9024
2017,185,179,6,0:00:17,0:02:17,0:02:33,0.7857
2017,172,164,8,0:00:18,0:02:27,0:04:09,0.7706
2017,57,51,6,0:00:07,0:01:47,0:03:40,0.9057
2017,200,192,8,0:00:10,0:02:18,0:02:49,0.8643
2017,202,199,3,0:00:08,0:02:05,0:01:17,0.91
2017,217,212,5,0:00:07,0:01:55,0:01:50,0.9442
2017,225,223,2,0:00:09,0:02:09,0:01:06,0.9193
2017,235,231,4,0:00:08,0:02:19,0:01:06,0.9571
2017,202,201,1,0:00:08,0:02:21,0:01:53,0.9455
2017,43,39,4,0:00:11,0:02:15,0:01:50,0.7619
2017,194,187,7,0:00:10,0:02:27,0:02:30,0.8743
2017,202,199,3,0:00:13,0:02:23,0:01:58,0.8607
2017,146,140,6,0:00:12,0:02:13,0:04:35,0.8345
2017,147,145,2,0:00:09,0:02:15,0:00:58,0.9116
2017,155,145,10,0:00:12,0:02:33,0:04:33,0.8224
2017,157,156,1,0:00:09,0:02:24,0:00:53,0.9295
2017,38,36,2,0:00:13,0:02:11,0:00:59,0.8378
2017,166,162,4,0:00:09,0:02:29,0:02:45,0.8909
2017,226,216,10,0:00:13,0:02:15,0:01:46,0.8145
2017,253,247,6,0:00:10,0:01:54,0:01:17,0.8849
2017,134,134,0,0:00:03,0:02:13,0:00:26,1
2017,70,67,3,0:00:12,0:02:01,0:01:16,0.8382
2017,83,82,1,0:00:07,0:02:03,0:01:16,0.9518
2017,42,40,2,0:00:08,0:01:51,0:01:36,0.9024
2017,66,64,2,0:00:05,0:02:00,0:01:39,0.9545
2017,153,146,7,0:00:20,0:02:08,0:04:32,0.76
2017,141,135,6,0:00:23,0:02:06,0:02:15,0.6691
2017,146,143,3,0:00:17,0:01:57,0:02:27,0.7832
2017,144,140,4,0:00:12,0:01:53,0:02:05,0.8403
2017,105,103,2,0:00:17,0:01:55,0:02:01,0.7619
2017,36,35,1,0:00:16,0:01:54,0:01:31,0.7714
2017,61,57,4,0:00:04,0:02:00,0:03:41,0.9167
2017,60,58,2,0:00:11,0:02:08,0:01:34,0.85
2017,18,17,1,0:00:05,0:02:39,0:00:20,1
2017,206,202,4,0:00:09,0:01:54,0:01:10,0.8927
2017,194,193,1,0:00:11,0:01:57,0:01:34,0.8497
2017,206,200,6,0:00:10,0:02:08,0:02:00,0.8627
2017,53,53,0,0:00:18,0:02:08,0:02:10,0.7736
2017,147,145,2,0:00:09,0:01:50,0:01:24,0.8836
2017,201,197,4,0:00:09,0:01:59,0:02:23,0.9095
2017,202,198,4,0:00:10,0:02:09,0:01:11,0.885
2017,226,219,7,0:00:10,0:02:12,0:02:45,0.88
2017,167,163,4,0:00:07,0:02:09,0:01:50,0.9277
2017,164,164,0,0:00:11,0:02:17,0:01:45,0.8902
2017,42,41,1,0:00:11,0:02:09,0:01:18,0.878
2017,79,78,1,0:00:07,0:02:23,0:00:48,0.9487
2018,165,162,3,0:00:09,0:02:09,0:01:50,0.897
2018,180,174,6,0:00:16,0:02:16,0:01:43,0.7778
2018,179,176,3,0:00:10,0:02:26,0:01:50,0.8764
2018,217,215,2,0:00:08,0:02:08,0:02:07,0.9171
2018,171,167,4,0:00:10,0:02:15,0:01:50,0.8647
2018,37,37,0,0:00:09,0:01:57,0:01:22,0.8649
2018,215,206,9,0:00:18,0:02:09,0:02:45,0.8095
2018,218,212,6,0:00:16,0:02:17,0:02:09,0.8426
2018,205,202,3,0:00:11,0:02:25,0:01:37,0.9069
2018,195,190,5,0:00:12,0:02:22,0:01:14,0.8901
2018,181,176,5,0:00:13,0:02:13,0:01:16,0.8222
2018,212,206,6,0:00:11,0:02:20,0:01:49,0.8942
2018,33,32,1,0:00:08,0:02:28,0:00:55,0.9091
2018,298,287,11,0:00:13,0:01:35,0:02:51,0.8333
2018,158,156,2,0:00:11,0:02:23,0:01:32,0.8981
2018,156,154,2,0:00:12,0:02:13,0:01:01,0.8581
2018,163,163,0,0:00:10,0:02:02,0:02:46,0.9264
2018,98,98,0,0:00:07,0:02:10,0:01:10,0.9388
2018,255,249,6,0:00:15,0:02:19,0:05:31,0.8268
2018,50,49,1,0:00:08,0:02:02,0:00:57,0.92
2018,290,289,1,0:00:12,0:02:01,0:01:10,0.8927
2018,296,281,15,0:00:22,0:02:08,0:04:30,0.7354
2018,260,257,3,0:00:17,0:02:13,0:01:20,0.8716
2018,201,193,8,0:00:19,0:02:23,0:02:02,0.7677
2018,132,131,1,0:00:17,0:02:13,0:01:30,0.7652
2018,167,165,2,0:00:09,0:02:06,0:00:57,0.9212
2018,85,79,6,0:00:18,0:02:25,0:01:53,0.7738
2018,244,236,8,0:00:21,0:02:29,0:01:56,0.7562
2018,186,182,4,0:00:14,0:02:13,0:01:38,0.7903
2018,278,264,14,0:00:19,0:02:20,0:02:10,0.7684
2018,272,268,4,0:00:15,0:02:30,0:01:45,0.8
2018,218,206,12,0:00:25,0:02:21,0:03:41,0.6728
2018,152,148,4,0:00:14,0:02:18,0:01:25,0.8333
2018,48,43,5,0:00:22,0:02:01,0:01:21,0.6957
2018,186,181,5,0:00:14,0:02:20,0:01:49,0.8495
2018,182,180,2,0:00:08,0:02:10,0:00:58,0.9337
2018,192,188,4,0:00:20,0:01:58,0:01:56,0.7619
2018,155,148,7,0:00:14,0:02:24,0:02:18,0.8533
2018,144,142,2,0:00:11,0:02:19,0:01:05,0.9021
2018,164,162,2,0:00:12,0:02:35,0:01:50,0.8537
2018,27,26,1,0:00:11,0:02:04,0:01:17,0.8148
2018,177,175,2,0:00:11,0:02:19,0:01:35,0.9086
2018,134,131,3,0:00:14,0:02:23,0:01:39,0.8134
2018,125,120,5,0:00:14,0:02:20,0:02:52,0.8455
2018,167,163,4,0:00:16,0:02:24,0:01:12,0.8121
2018,169,167,2,0:00:09,0:02:14,0:01:44,0.8994
2018,162,160,2,0:00:16,0:02:15,0:01:31,0.8313
2018,25,25,0,0:00:16,0:02:35,0:00:58,0.76
2018,157,146,11,0:00:17,0:02:17,0:01:51,0.7974
2018,166,154,12,0:00:25,0:02:18,0:03:39,0.6626
2018,58,55,3,0:00:16,0:02:11,0:02:45,0.7414
2018,75,74,1,0:00:15,0:02:13,0:03:18,0.84
2018,28,28,0,0:00:07,0:02:28,0:00:51,0.9643
2018,108,107,1,0:00:09,0:02:11,0:00:59,0.9444
2018,21,21,0,0:00:07,0:02:58,0:00:58,0.9524
2018,189,182,7,0:00:21,0:02:10,0:04:46,0.7634
2018,161,155,6,0:00:19,0:02:27,0:01:50,0.7188
2018,155,151,4,0:00:17,0:02:20,0:01:49,0.8052
2018,161,150,11,0:00:17,0:02:22,0:02:45,0.7532
2018,132,129,3,0:00:27,0:02:22,0:02:34,0.6515
2018,122,119,3,0:00:16,0:02:24,0:01:50,0.8
2018,17,17,0,0:00:21,0:02:40,0:00:58,0.7647
2018,45,45,0,0:00:06,0:02:06,0:00:57,0.9556
2018,177,172,5,0:00:20,0:02:23,0:02:51,0.76
2018,133,132,1,0:00:10,0:02:25,0:00:59,0.9323
2018,177,167,10,0:00:15,0:02:22,0:04:35,0.8324
2018,127,124,3,0:00:16,0:02:22,0:01:45,0.8189
2018,148,147,1,0:00:16,0:02:11,0:03:11,0.8311
2018,23,23,0,0:00:32,0:02:02,0:02:43,0.6522
2018,141,134,7,0:00:24,0:02:38,0:02:29,0.7214
2018,124,120,4,0:00:20,0:02:33,0:02:58,0.8226
2018,165,156,9,0:00:25,0:02:21,0:02:38,0.7055
2018,168,166,2,0:00:21,0:02:33,0:03:43,0.8012
2018,198,188,10,0:00:22,0:02:32,0:02:45,0.7092
2018,139,133,6,0:00:17,0:02:40,0:03:03,0.8015
2018,46,45,1,0:00:10,0:02:14,0:01:16,0.8889
2018,184,174,10,0:00:23,0:02:37,0:04:35,0.7654
2018,207,190,17,0:00:21,0:02:23,0:04:06,0.7136
2018,191,180,11,0:00:21,0:02:32,0:01:53,0.765
2018,213,204,9,0:00:24,0:02:26,0:02:46,0.6967
2018,483,451,32,0:00:16,0:00:57,0:08:45,0.792
2018,547,526,21,0:00:19,0:01:21,0:03:54,0.8158
2018,54,53,1,0:00:25,0:02:36,0:01:18,0.7037
2018,275,261,14,0:00:22,0:02:13,0:02:12,0.7444
2018,205,195,10,0:00:24,0:02:34,0:03:00,0.7079
2018,80,77,3,0:00:10,0:02:11,0:01:33,0.8961
2018,200,195,5,0:00:21,0:02:30,0:02:48,0.7525
2018,154,150,4,0:00:21,0:02:29,0:02:45,0.7434
2018,163,155,8,0:00:23,0:02:18,0:02:26,0.7452
2018,12,12,0,0:00:25,0:03:37,0:01:28,0.6667
2018,218,212,6,0:00:20,0:01:56,0:04:11,0.7593
2018,172,163,9,0:00:18,0:02:09,0:01:53,0.8193
2018,205,194,11,0:00:18,0:02:24,0:01:41,0.806
2018,178,168,10,0:00:23,0:02:28,0:02:50,0.6897
2018,214,201,13,0:00:23,0:02:11,0:02:24,0.6603
2018,169,161,8,0:00:23,0:02:17,0:04:35,0.7169
2018,46,46,0,0:00:25,0:02:24,0:01:35,0.7174
2018,183,177,6,0:00:18,0:02:30,0:01:07,0.8111
2018,208,190,18,0:00:21,0:02:25,0:01:50,0.7411
2019,234,224,10,0:00:22,0:02:15,0:03:20,0.7414
2019,204,194,10,0:00:18,0:02:17,0:01:50,0.7871
2019,204,189,15,0:00:21,0:02:15,0:03:56,0.7079
2019,99,99,0,0:00:16,0:02:25,0:01:02,0.8283
2019,29,27,2,0:00:19,0:02:47,0:02:22,0.7857
2019,167,159,8,0:00:23,0:02:28,0:04:35,0.7048
2019,164,161,3,0:00:17,0:02:35,0:01:37,0.8171
2019,158,147,11,0:00:21,0:02:34,0:02:03,0.7244
2019,165,161,4,0:00:17,0:02:26,0:01:06,0.7791
2019,129,124,5,0:00:23,0:02:28,0:01:50,0.7087
2019,155,149,6,0:00:23,0:02:26,0:04:19,0.7451
2019,24,22,2,0:00:28,0:02:24,0:01:21,0.5417
2019,209,200,9,0:00:23,0:02:24,0:02:11,0.6667
2019,239,226,13,0:00:26,0:02:19,0:02:50,0.6723
2019,229,210,19,0:00:29,0:02:23,0:08:16,0.6416
2019,194,172,22,0:00:23,0:02:20,0:06:16,0.6614
2019,202,179,23,0:00:24,0:02:16,0:02:50,0.6443
2019,268,254,14,0:00:15,0:01:51,0:02:40,0.8113
2019,52,49,3,0:00:18,0:02:18,0:02:17,0.7647
2019,414,397,17,0:00:23,0:01:58,0:05:32,0.7073
2019,346,325,21,0:00:27,0:02:22,0:02:45,0.6569
2019,187,179,8,0:00:25,0:02:14,0:02:59,0.6703
2019,203,186,17,0:00:24,0:02:38,0:04:35,0.6959
2019,204,194,10,0:00:18,0:02:33,0:02:02,0.8241
2019,126,121,5,0:00:21,0:02:32,0:01:51,0.7063
2019,36,36,0,0:00:17,0:02:07,0:01:31,0.7778
2019,180,165,15,0:00:27,0:02:30,0:02:19,0.6609
2019,169,162,7,0:00:20,0:02:25,0:01:53,0.7456
2019,155,151,4,0:00:21,0:02:20,0:02:45,0.7097
2019,169,137,32,0:00:38,0:02:24,0:05:30,0.4036
2019,61,45,16,0:00:32,0:02:49,0:05:30,0.4098
2019,167,136,31,0:00:42,0:02:36,0:05:28,0.3598
2019,32,27,5,0:00:35,0:02:22,0:03:10,0.5313
2019,229,148,81,0:00:36,0:02:48,0:10:39,0.4318
2019,208,204,4,0:00:19,0:03:06,0:05:14,0.7767
2019,175,168,7,0:00:25,0:02:51,0:03:44,0.6512
2019,177,167,10,0:00:22,0:02:41,0:04:24,0.6839
2019,822,767,55,0:00:24,0:01:25,0:04:35,0.644
2019,87,85,2,0:00:23,0:02:25,0:02:17,0.6782
2019,41,39,2,0:00:15,0:02:42,0:01:18,0.825
2019,280,257,23,0:00:31,0:02:33,0:07:55,0.6387
2019,199,192,7,0:00:22,0:02:46,0:02:48,0.7387
2019,252,239,13,0:00:29,0:02:29,0:03:36,0.6492
2019,220,208,12,0:00:20,0:02:36,0:02:45,0.7559
2019,206,193,13,0:00:24,0:02:27,0:03:37,0.7549
2019,217,206,11,0:00:22,0:02:26,0:02:02,0.7103
2019,24,24,0,0:00:19,0:02:50,0:01:07,0.7917
2019,248,238,10,0:00:13,0:02:27,0:01:50,0.8525
2019,222,212,10,0:00:20,0:02:25,0:03:41,0.7773
2019,190,178,12,0:00:32,0:02:27,0:02:45,0.5508
2019,238,231,7,0:00:20,0:02:27,0:02:03,0.7966
2019,214,205,9,0:00:20,0:02:34,0:02:34,0.7905
2019,186,176,10,0:00:23,0:02:15,0:05:03,0.7088
2019,21,20,1,0:00:14,0:02:25,0:00:54,0.85
2019,169,157,12,0:00:21,0:02:29,0:04:30,0.7771
2019,149,141,8,0:00:16,0:02:38,0:02:37,0.7905
2019,171,164,7,0:00:19,0:02:22,0:03:49,0.7719
2019,127,122,5,0:00:13,0:02:22,0:01:25,0.878
2019,21,21,0,0:00:08,0:03:03,0:00:58,0.9048
2019,5,5,0,0:00:14,0:02:37,0:00:59,0.8
2019,33,32,1,0:00:26,0:02:04,0:01:45,0.6667
2019,145,139,6,0:00:20,0:02:28,0:03:41,0.7902
2019,129,127,2,0:00:19,0:02:13,0:01:49,0.7559
2019,194,178,16,0:00:26,0:02:36,0:05:20,0.6719
2019,194,187,7,0:00:24,0:02:25,0:03:44,0.7725
2019,202,195,7,0:00:21,0:02:21,0:02:59,0.7475
2019,214,208,6,0:00:13,0:02:19,0:00:57,0.8815
2019,28,28,0,0:00:13,0:02:13,0:01:18,0.8929
2019,191,187,4,0:00:15,0:02:23,0:01:40,0.8254
2019,205,197,8,0:00:21,0:02:27,0:02:23,0.7438
2019,198,196,2,0:00:23,0:02:28,0:02:03,0.736
2019,184,177,7,0:00:20,0:02:41,0:01:50,0.7857
2019,184,174,10,0:00:25,0:02:27,0:02:47,0.7
2019,168,160,8,0:00:26,0:02:25,0:02:04,0.6826
2019,39,37,2,0:00:14,0:02:08,0:01:03,0.8108
2019,225,210,15,0:00:28,0:02:13,0:02:33,0.6697
2019,182,174,8,0:00:32,0:02:16,0:03:56,0.6022
2019,346,305,41,0:00:45,0:01:57,0:05:07,0.4503
2019,450,441,9,0:00:19,0:01:53,0:02:31,0.783
2019,259,248,11,0:00:20,0:02:06,0:01:51,0.7539
2019,231,214,17,0:00:18,0:02:06,0:02:31,0.7956
2019,48,47,1,0:00:13,0:02:03,0:01:46,0.8958
2019,246,236,10,0:00:20,0:02:11,0:04:36,0.7918
2019,202,195,7,0:00:25,0:02:15,0:05:33,0.745
2019,153,150,3,0:00:15,0:02:15,0:02:12,0.8224
2019,178,172,6,0:00:19,0:02:15,0:04:35,0.7829
2019,172,165,7,0:00:19,0:02:24,0:03:24,0.7929
2019,208,200,8,0:00:26,0:02:23,0:03:15,0.6878
2019,77,76,1,0:00:29,0:02:16,0:01:54,0.5844
2019,291,250,41,0:00:41,0:02:20,0:07:10,0.5544
2019,219,212,7,0:00:21,0:02:19,0:01:50,0.7685
2019,173,169,4,0:00:18,0:02:13,0:02:14,0.814
2019,204,197,7,0:00:17,0:02:23,0:01:57,0.8
2019,216,185,31,0:00:30,0:02:17,0:06:26,0.6143
2019,461,441,20,0:00:30,0:02:18,0:03:40,0.6149
2019,56,55,1,0:00:26,0:02:11,0:01:53,0.6607
2019,192,176,16,0:00:23,0:02:05,0:02:47,0.6828
2019,382,365,17,0:00:20,0:01:35,0:02:53,0.7314
2019,246,223,23,0:00:25,0:02:14,0:05:24,0.7167
2019,48,46,2,0:00:26,0:02:14,0:01:25,0.7234
2019,221,205,16,0:00:26,0:02:15,0:03:15,0.6308
2019,275,261,14,0:00:33,0:02:19,0:02:58,0.5852
2019,39,36,3,0:00:19,0:01:53,0:01:52,0.7778
2019,250,236,14,0:00:29,0:02:08,0:04:07,0.5904
2019,197,184,13,0:00:29,0:02:23,0:03:41,0.5561
2019,223,208,15,0:00:28,0:02:21,0:06:51,0.7227
2019,240,236,4,0:00:18,0:02:14,0:02:08,0.7792
2019,55,52,3,0:00:16,0:02:19,0:01:42,0.7818
2020,59,54,5,0:00:08,0:02:06,0:02:01,0.8475
2020,36,31,5,0:00:11,0:02:22,0:01:56,0.7222
2020,229,219,10,0:00:13,0:02:07,0:02:35,0.8489
2020,206,189,17,0:00:15,0:02:19,0:03:48,0.8283
2020,225,200,25,0:00:21,0:02:21,0:04:42,0.7311
2020,200,193,7,0:00:17,0:02:23,0:03:40,0.7929
2020,189,179,10,0:00:22,0:02:10,0:06:41,0.7807
2020,169,159,10,0:00:22,0:02:23,0:03:26,0.7365
2020,41,40,1,0:00:25,0:02:32,0:02:05,0.6829
2020,218,187,31,0:00:48,0:02:15,0:05:13,0.5211
2020,194,185,9,0:00:21,0:02:10,0:02:45,0.7158
2020,176,172,4,0:00:16,0:02:20,0:02:15,0.8208
2020,181,179,2,0:00:18,0:02:21,0:02:17,0.8056
2020,159,151,8,0:00:29,0:01:59,0:03:41,0.6101
2020,144,135,9,0:00:24,0:02:12,0:06:25,0.7063
2020,30,29,1,0:00:33,0:02:58,0:02:16,0.6
2020,197,185,12,0:00:24,0:02:18,0:02:20,0.6823
2020,56,47,9,0:00:24,0:02:22,0:02:48,0.5893
2020,182,153,29,0:00:38,0:02:17,0:10:41,0.5389
2020,178,166,12,0:00:30,0:02:24,0:05:12,0.6207
2020,183,164,19,0:00:25,0:02:04,0:03:40,0.6591
2020,197,182,15,0:00:28,0:02:25,0:04:20,0.648
2020,60,58,2,0:00:37,0:02:36,0:03:10,0.5424
2020,241,224,17,0:00:23,0:02:25,0:02:45,0.7046
2020,307,295,12,0:00:29,0:02:16,0:02:45,0.6046
2020,295,289,6,0:00:26,0:02:23,0:03:11,0.7069
2020,239,230,9,0:00:26,0:02:14,0:03:14,0.6891
2020,241,231,10,0:00:23,0:02:25,0:01:52,0.7246
2020,211,195,16,0:00:33,0:02:42,0:03:16,0.524
2020,40,35,5,0:00:40,0:02:35,0:03:12,0.475
2020,192,174,18,0:00:32,0:02:16,0:03:40,0.5579
2020,201,179,22,0:00:35,0:02:18,0:03:40,0.5729
2020,274,247,27,0:00:28,0:02:10,0:04:04,0.6394
2020,205,176,29,0:00:41,0:02:16,0:05:11,0.4623
2020,177,160,17,0:00:28,0:02:20,0:03:59,0.592
2020,159,151,8,0:00:22,0:02:08,0:07:22,0.7325
2020,33,28,5,0:00:13,0:02:30,0:01:02,0.6667
2020,228,210,18,0:00:23,0:02:08,0:03:09,0.6667
2020,177,172,5,0:00:25,0:02:15,0:02:52,0.6914
2020,197,169,28,0:00:34,0:02:30,0:07:41,0.5567
2020,721,616,105,0:00:57,0:01:55,0:05:48,0.2831
2020,301,270,31,0:00:42,0:02:05,0:10:06,0.4247
2020,179,175,4,0:00:24,0:02:21,0:03:12,0.7135
2020,45,45,0,0:00:16,0:02:11,0:03:21,0.8667
2020,180,164,16,0:00:25,0:02:22,0:01:50,0.618
2020,206,200,6,0:00:22,0:02:19,0:02:07,0.7463
2020,187,181,6,0:00:32,0:02:30,0:03:54,0.627
2020,186,177,9,0:00:28,0:02:22,0:05:30,0.6793
2020,189,180,9,0:00:35,0:02:15,0:03:24,0.5645
2020,127,116,11,0:00:34,0:02:25,0:02:46,0.5645
2020,93,90,3,0:00:26,0:01:57,0:02:57,0.6344
2020,328,292,36,0:00:37,0:02:17,0:06:25,0.4968
2020,238,223,15,0:00:33,0:02:23,0:03:40,0.5923
2020,237,222,15,0:00:34,0:02:24,0:02:52,0.5385
2020,257,235,22,0:00:45,0:02:31,0:04:24,0.4466
2020,238,223,15,0:00:32,0:02:17,0:03:22,0.547
2020,199,164,35,0:00:32,0:02:13,0:06:56,0.5918
2020,30,27,3,0:00:32,0:02:34,0:02:37,0.6071
2020,176,163,13,0:00:38,0:02:05,0:05:30,0.5429
2020,162,144,18,0:00:41,0:02:25,0:03:40,0.5031
2020,169,157,12,0:00:29,0:02:29,0:01:56,0.5389
2020,155,146,9,0:00:30,0:02:18,0:03:10,0.5098
2020,247,205,42,0:00:49,0:02:26,0:07:36,0.3849
2020,191,186,5,0:00:24,0:02:14,0:01:54,0.7053
2020,30,29,1,0:00:06,0:02:15,0:00:46,0.9333
2020,316,290,26,0:00:31,0:02:21,0:04:02,0.5916
2020,211,195,16,0:00:34,0:02:21,0:06:25,0.5577
2020,208,169,39,0:00:45,0:02:18,0:07:15,0.4585
2020,130,124,6,0:00:22,0:02:17,0:02:15,0.6899
2020,134,129,5,0:00:24,0:02:12,0:03:28,0.709
2020,124,121,3,0:00:27,0:02:19,0:03:19,0.7073
2020,47,43,4,0:00:37,0:02:18,0:03:16,0.5435
2020,197,186,11,0:00:28,0:02:18,0:02:27,0.6383
2020,158,146,12,0:00:31,0:02:24,0:03:40,0.5696
2020,163,151,12,0:00:28,0:02:13,0:04:53,0.6375
2020,178,160,18,0:00:35,0:02:39,0:04:41,0.5449
2020,151,128,23,0:00:35,0:02:23,0:05:38,0.5338
2020,118,106,12,0:00:33,0:02:25,0:04:32,0.5517
2020,31,28,3,0:00:40,0:02:40,0:03:12,0.4333
2020,139,134,5,0:00:31,0:02:23,0:02:50,0.5942
2020,171,154,17,0:00:27,0:02:24,0:06:28,0.6566
2020,160,156,4,0:00:27,0:02:15,0:01:47,0.6456
2020,177,169,8,0:00:29,0:02:31,0:03:40,0.6437
2020,187,180,7,0:00:26,0:02:22,0:05:56,0.6559
2020,147,138,9,0:00:26,0:02:24,0:05:19,0.6138
2020,35,35,0,0:00:08,0:02:10,0:00:47,0.8857
2020,208,194,14,0:00:35,0:02:26,0:04:26,0.5693
2020,162,155,7,0:00:19,0:02:17,0:03:43,0.7799
2020,152,143,9,0:00:22,0:02:28,0:03:41,0.7
2020,132,125,7,0:00:26,0:02:07,0:03:52,0.6894
2020,133,131,2,0:00:12,0:02:19,0:01:19,0.8712
2020,129,121,8,0:00:33,0:02:37,0:04:01,0.6142
2020,37,35,2,0:00:19,0:02:21,0:01:32,0.7568
2020,56,54,2,0:00:13,0:02:33,0:02:13,0.8727
2020,215,210,5,0:00:12,0:01:34,0:01:42,0.8774
2020,50,46,4,0:00:14,0:02:42,0:01:13,0.72
2020,136,129,7,0:00:22,0:02:26,0:02:30,0.6642
2020,160,142,18,0:00:35,0:02:34,0:03:10,0.5592
2020,132,115,17,0:00:36,0:02:27,0:04:35,0.4884
2020,30,28,2,0:00:47,0:02:36,0:02:22,0.4
2020,150,140,10,0:00:29,0:02:32,0:02:11,0.6309
2020,160,144,16,0:00:46,0:02:39,0:04:25,0.4968
2020,132,122,10,0:00:37,0:02:38,0:03:51,0.5
2020,161,151,10,0:00:28,0:02:07,0:02:50,0.6139
2021,156,149,7,0:00:22,0:02:28,0:04:11,0.7032
2021,137,128,9,0:00:31,0:02:30,0:05:04,0.6269
2021,28,25,3,0:01:00,0:02:47,0:04:46,0.3214
2021,141,133,8,0:00:33,0:02:42,0:04:38,0.6331
2021,130,123,7,0:00:32,0:02:40,0:02:20,0.5349
2021,161,155,6,0:00:27,0:02:43,0:02:43,0.7358
2021,139,132,7,0:00:28,0:02:40,0:01:51,0.6331
2021,167,130,37,0:00:29,0:02:34,0:11:56,0.546
2021,138,122,16,0:00:35,0:02:49,0:05:30,0.5778
2021,47,44,3,0:00:26,0:03:11,0:03:29,0.6304
2021,230,206,24,0:00:38,0:02:34,0:04:35,0.4672
2021,177,153,24,0:00:30,0:02:53,0:04:28,0.5549
2021,159,149,10,0:00:33,0:02:40,0:04:32,0.6104
2021,151,135,16,0:00:36,0:02:32,0:04:41,0.5274
2021,138,126,12,0:00:34,0:02:17,0:04:10,0.597
2021,118,118,0,0:00:26,0:02:33,0:01:38,0.661
2021,22,21,1,0:00:42,0:02:24,0:02:56,0.5238
2021,177,156,21,0:00:42,0:02:39,0:03:16,0.4237
2021,156,147,9,0:00:29,0:02:31,0:03:41,0.6364
2021,123,121,2,0:00:26,0:02:28,0:03:29,0.6423
2021,130,125,5,0:00:26,0:02:29,0:03:28,0.6693
2021,141,134,7,0:00:39,0:02:33,0:03:08,0.5643
2021,121,113,8,0:00:38,0:02:38,0:04:18,0.5083
2021,35,31,4,0:00:34,0:02:05,0:04:29,0.4706
2021,240,226,14,0:00:36,0:02:15,0:04:06,0.5702
2021,130,118,12,0:00:32,0:02:23,0:03:40,0.5781
2021,140,130,10,0:00:29,0:02:31,0:07:35,0.6232
2021,131,111,20,0:00:38,0:03:16,0:09:59,0.5969
2021,74,74,0,0:00:13,0:02:55,0:01:53,0.8919
2021,24,24,0,0:00:12,0:02:47,0:00:57,0.8333
2021,11,10,1,0:00:13,0:02:24,0:00:55,0.8182
2021,28,26,2,0:00:10,0:02:30,0:01:26,0.8148
2021,43,43,0,0:00:08,0:02:23,0:00:52,0.8837
2021,62,62,0,0:00:17,0:02:12,0:01:26,0.8226
2021,70,69,1,0:00:22,0:02:06,0:08:40,0.8143
2021,107,97,10,0:00:21,0:02:26,0:02:40,0.6887
2021,91,85,6,0:00:30,0:02:27,0:05:49,0.6264
2021,25,25,0,0:00:11,0:02:40,0:00:55,0.84
2021,85,79,6,0:00:24,0:02:31,0:03:07,0.7229
2021,91,83,8,0:00:26,0:02:37,0:03:40,0.6264
2021,48,46,2,0:00:11,0:02:13,0:01:22,0.8298
2021,14,11,3,0:00:18,0:02:27,0:02:45,0.6154
2021,43,42,1,0:00:22,0:02:47,0:03:15,0.7381
2021,74,69,5,0:00:23,0:02:31,0:04:48,0.7671
2021,33,33,0,0:00:14,0:02:25,0:01:29,0.8182
2021,124,112,12,0:00:26,0:02:36,0:05:30,0.6475
2021,130,126,4,0:00:25,0:02:30,0:02:58,0.6589
2021,139,139,0,0:00:18,0:02:40,0:03:03,0.7754
2021,138,130,8,0:00:26,0:02:27,0:01:52,0.6148
2021,125,119,6,0:00:22,0:02:29,0:03:40,0.68
2021,98,96,2,0:00:20,0:02:36,0:02:53,0.7732
2021,12,12,0,0:00:18,0:03:07,0:01:36,0.8333
2021,119,117,2,0:00:18,0:02:39,0:02:43,0.7815
2021,100,96,4,0:00:21,0:02:37,0:02:45,0.76
2021,146,133,13,0:00:31,0:02:30,0:03:40,0.5775
2021,131,127,4,0:00:22,0:02:25,0:02:28,0.7266
2021,107,104,3,0:00:08,0:02:27,0:01:36,0.9245
2021,112,105,7,0:00:24,0:02:38,0:04:28,0.6727
2021,21,21,0,0:00:32,0:02:31,0:01:25,0.5238
2021,125,104,21,0:00:37,0:02:44,0:02:45,0.4463
2021,35,34,1,0:00:24,0:02:12,0:02:16,0.7429
2021,121,109,12,0:00:38,0:02:32,0:05:21,0.5378
2021,135,122,13,0:00:32,0:02:34,0:03:08,0.5758
2021,117,114,3,0:00:22,0:02:38,0:02:27,0.7586
2021,114,97,17,0:00:39,0:02:50,0:08:16,0.4513
2021,50,49,1,0:00:35,0:02:55,0:02:22,0.52
2021,207,198,9,0:00:16,0:02:43,0:03:51,0.8049
2021,189,183,6,0:00:21,0:02:31,0:03:58,0.7419
2021,162,156,6,0:00:24,0:02:22,0:02:08,0.6646
2021,177,165,12,0:00:26,0:02:31,0:03:50,0.6647
2021,177,167,10,0:00:23,0:02:35,0:02:45,0.6897
2021,163,134,29,0:00:38,0:02:42,0:07:16,0.472
2021,24,20,4,0:00:26,0:03:23,0:02:16,0.6522
2021,146,139,7,0:00:18,0:02:34,0:06:21,0.7586
2021,143,141,2,0:00:22,0:02:45,0:02:45,0.7203
2021,132,122,10,0:00:31,0:02:28,0:04:36,0.5649
2021,137,130,7,0:00:26,0:02:25,0:02:06,0.6444
2021,112,104,8,0:00:43,0:02:37,0:04:07,0.4091
2021,110,91,19,0:00:50,0:02:38,0:05:12,0.367
2021,24,22,2,0:00:32,0:02:14,0:04:46,0.5833
2021,168,154,14,0:00:36,0:02:44,0:03:52,0.494
2021,146,116,30,0:00:42,0:02:28,0:15:00,0.5493
2021,100,95,5,0:00:31,0:02:38,0:02:53,0.57
2021,144,131,13,0:00:26,0:02:27,0:02:37,0.6357
2021,110,104,6,0:00:24,0:02:26,0:02:22,0.6422
2021,126,111,15,0:00:31,0:02:38,0:04:36,0.528
2021,24,24,0,0:00:48,0:02:54,0:04:44,0.4167
2021,128,122,6,0:00:35,0:02:59,0:02:42,0.5156
2021,185,176,9,0:00:27,0:02:23,0:05:05,0.6793
2021,136,114,22,0:00:57,0:02:25,0:05:31,0.2879
2021,130,116,14,0:00:44,0:02:41,0:06:00,0.4444
2021,103,101,2,0:00:18,0:02:42,0:02:23,0.7745
2021,99,89,10,0:00:20,0:02:27,0:01:30,0.7368
2021,26,24,2,0:00:23,0:02:00,0:01:53,0.68
2021,95,94,1,0:00:21,0:02:31,0:03:34,0.7553
2021,136,131,5,0:00:17,0:02:29,0:02:21,0.8106
2021,37,34,3,0:00:41,0:02:11,0:05:46,0.6486
2021,105,100,5,0:00:22,0:02:30,0:02:12,0.7228
2021,100,92,8,0:00:30,0:02:27,0:04:35,0.6327
2021,115,103,12,0:00:44,0:02:46,0:04:35,0.3717
2021,38,36,2,0:00:39,0:02:56,0:02:54,0.5263
2021,108,95,13,0:00:26,0:02:49,0:02:46,0.6381
2021,124,118,6,0:00:23,0:02:31,0:03:01,0.7377
2021,97,92,5,0:00:25,0:02:36,0:02:23,0.6771
2021,117,108,9,0:00:37,0:01:46,0:04:03,0.4867
2021,34,31,3,0:00:27,0:02:37,0:02:32,0.6471
2021,53,50,3,0:00:28,0:02:11,0:03:16,0.6604
2021,29,23,6,0:00:42,0:02:47,0:03:40,0.3214
2021,120,107,13,0:00:34,0:02:39,0:03:21,0.4407
2021,107,100,7,0:00:33,0:02:33,0:02:08,0.5143
2021,173,159,14,0:00:47,0:02:44,0:05:30,0.3941
2021,256,213,43,0:00:44,0:02:45,0:05:18,0.417
2021,199,174,25,0:00:36,0:02:35,0:04:35,0.5306
2021,182,170,12,0:00:40,0:02:44,0:03:27,0.4581
2021,42,41,1,0:00:42,0:02:53,0:03:40,0.561
2021,181,168,13,0:00:34,0:02:35,0:02:43,0.5169
2021,159,147,12,0:00:30,0:02:36,0:04:39,0.5871
2021,142,134,8,0:00:26,0:02:50,0:01:50,0.6187
2021,194,163,31,0:00:30,0:02:38,0:05:31,0.5104
2021,235,210,25,0:00:38,0:02:53,0:04:35,0.489
2021,206,180,26,0:00:51,0:02:47,0:07:03,0.3861
2021,58,47,11,0:00:48,0:02:36,0:04:35,0.4211
2021,212,194,18,0:00:38,0:02:33,0:04:21,0.512
2021,232,214,18,0:00:34,0:02:36,0:05:30,0.559
2021,348,327,21,0:00:32,0:02:28,0:07:20,0.5462
2021,167,156,11,0:00:32,0:02:43,0:02:57,0.5679
2021,167,157,10,0:00:27,0:02:57,0:05:19,0.6748
2021,166,161,5,0:00:21,0:02:45,0:01:32,0.7333
2021,32,28,4,0:00:22,0:02:43,0:07:35,0.6452
2021,52,49,3,0:00:32,0:02:58,0:03:02,0.6346
2021,154,149,5,0:00:26,0:02:52,0:01:50,0.649
2021,223,218,5,0:00:18,0:02:07,0:02:00,0.8009
2021,170,157,13,0:00:17,0:03:04,0:06:25,0.7844
2021,145,133,12,0:00:26,0:02:56,0:03:39,0.6923
2021,144,138,6,0:00:17,0:02:53,0:02:45,0.838
2021,16,15,1,0:00:17,0:03:00,0:02:45,0.6875
2021,135,131,4,0:00:20,0:02:37,0:02:00,0.7612
2021,137,133,4,0:00:24,0:02:49,0:02:46,0.6912
2021,149,144,5,0:00:17,0:02:39,0:02:02,0.8276
2021,155,143,12,0:00:16,0:02:41,0:06:25,0.8014
2021,128,121,7,0:00:19,0:02:55,0:04:35,0.7778
2021,134,125,9,0:00:21,0:02:38,0:03:18,0.7252
2021,21,21,0,0:00:23,0:02:37,0:02:50,0.7619
2021,150,138,12,0:00:30,0:02:52,0:04:16,0.5867
2021,163,158,5,0:00:14,0:02:28,0:02:01,0.8199
2021,160,151,9,0:00:12,0:02:39,0:02:57,0.8718
2021,132,125,7,0:00:30,0:02:46,0:03:47,0.6462
2021,131,126,5,0:00:17,0:02:47,0:02:35,0.7829
2021,158,146,12,0:00:21,0:02:42,0:03:40,0.7532
2021,19,16,3,0:00:51,0:02:46,0:04:14,0.4737
2021,151,128,23,0:00:52,0:02:30,0:05:38,0.3793
2021,139,128,11,0:00:32,0:02:44,0:03:34,0.518
2021,166,135,31,0:00:41,0:02:40,0:05:09,0.465
2021,258,196,62,0:01:10,0:02:30,0:07:51,0.2429
2021,203,176,27,0:00:40,0:02:30,0:09:09,0.4478
2021,182,162,20,0:00:25,0:02:48,0:03:40,0.5943
2021,18,17,1,0:00:55,0:04:01,0:05:46,0.5
2021,215,170,45,0:00:55,0:02:49,0:07:26,0.4306
2021,209,203,6,0:00:25,0:02:42,0:03:40,0.7488
2021,140,134,6,0:00:20,0:02:59,0:03:21,0.7626
2021,124,110,14,0:00:15,0:02:56,0:08:16,0.8182
2021,179,163,16,0:00:23,0:02:44,0:04:17,0.7159
2021,163,161,2,0:00:10,0:02:40,0:01:51,0.9441
2021,27,27,0,0:00:05,0:02:48,0:00:19,1
2021,182,175,7,0:00:19,0:02:38,0:03:08,0.7989
2021,164,159,5,0:00:11,0:02:23,0:06:28,0.9018
2021,160,159,1,0:00:05,0:02:40,0:00:58,0.9874
2021,174,155,19,0:00:16,0:02:41,0:06:39,0.7706
2021,235,230,5,0:00:05,0:02:27,0:01:50,0.9574
2021,175,174,1,0:00:04,0:02:26,0:01:53,0.9886
2021,25,25,0,0:00:04,0:03:15,0:00:55,0.96
2021,170,167,3,0:00:06,0:02:35,0:03:40,0.9408
2021,187,168,19,0:00:26,0:02:20,0:04:49,0.7043
2021,53,51,2,0:00:06,0:02:29,0:01:50,0.8868
2021,121,117,4,0:00:13,0:02:36,0:02:41,0.8583
2021,143,139,4,0:00:05,0:02:26,0:01:56,0.9441
2021,100,96,4,0:00:06,0:02:28,0:01:50,0.9192
2021,17,17,0,0:00:08,0:02:55,0:00:59,0.8824
2021,113,110,3,0:00:08,0:02:33,0:01:18,0.9018
2021,139,128,11,0:00:13,0:02:38,0:03:40,0.8201
2021,135,134,1,0:00:04,0:02:34,0:01:50,0.9852
2021,29,29,0,0:00:15,0:03:13,0:01:29,0.7931
2021,120,116,4,0:00:05,0:02:43,0:02:45,0.9583
2021,115,108,7,0:00:09,0:02:50,0:04:25,0.887
2021,14,14,0,0:00:14,0:02:17,0:01:14,0.7857
2021,107,104,3,0:00:07,0:02:29,0:00:58,0.9057
2021,137,128,9,0:00:10,0:02:30,0:02:03,0.8529
2021,106,105,1,0:00:11,0:02:47,0:01:53,0.8585
2021,116,108,8,0:00:19,0:02:26,0:02:33,0.8407
2021,120,117,3,0:00:09,0:02:37,0:01:05,0.9076
2021,123,121,2,0:00:07,0:02:27,0:01:55,0.9106
2021,31,31,0,0:00:03,0:02:18,0:00:03,1
2021,140,139,1,0:00:08,0:02:39,0:01:11,0.9214
2021,168,161,7,0:00:18,0:02:24,0:02:24,0.7365
2022,146,144,2,0:00:06,0:02:38,0:00:58,0.9448
2022,110,106,4,0:00:15,0:02:50,0:02:30,0.8
2022,342,333,9,0:00:15,0:02:10,0:02:39,0.8142
2022,190,183,7,0:00:16,0:02:32,0:01:59,0.7895
2022,25,24,1,0:00:06,0:02:22,0:00:48,0.9167
2022,169,162,7,0:00:09,0:02:31,0:04:36,0.8916
2022,130,129,1,0:00:11,0:02:30,0:01:52,0.8692
2022,22,20,2,0:00:09,0:03:15,0:01:50,0.9048
2022,5,5,0,0:00:28,0:02:25,0:01:14,0.6
2022,119,115,4,0:00:11,0:02:28,0:01:50,0.8644
2022,140,138,2,0:00:09,0:02:17,0:02:11,0.9214
2022,22,22,0,0:00:06,0:02:21,0:00:48,0.9091
2022,126,124,2,0:00:08,0:02:35,0:00:58,0.944
2022,122,111,11,0:00:13,0:02:43,0:02:13,0.7769
2022,113,108,5,0:00:13,0:02:31,0:01:27,0.8288
2022,119,109,10,0:00:17,0:02:36,0:05:15,0.8362
2022,134,119,15,0:00:24,0:02:46,0:02:45,0.6343
2022,101,97,4,0:00:16,0:02:33,0:01:38,0.77
2022,20,20,0,0:00:04,0:02:24,0:00:18,1
2022,169,162,7,0:00:17,0:02:32,0:05:31,0.8012
2022,137,133,4,0:00:29,0:02:37,0:02:42,0.6204
2022,133,127,6,0:00:18,0:02:39,0:04:36,0.8195
2022,184,179,5,0:00:10,0:02:03,0:02:44,0.9056
2022,145,135,10,0:00:21,0:02:35,0:03:10,0.7413
2022,114,108,6,0:00:14,0:02:31,0:02:33,0.8288
2022,24,23,1,0:00:05,0:02:12,0:00:55,0.9583
2022,143,136,7,0:00:09,0:02:32,0:05:30,0.8451
2022,119,114,5,0:00:08,0:02:22,0:01:19,0.906
2022,123,118,5,0:00:21,0:02:46,0:02:44,0.7073
2022,145,141,4,0:00:14,0:02:36,0:01:50,0.8333
2022,108,106,2,0:00:26,0:02:50,0:04:57,0.6822
2022,128,125,3,0:00:13,0:02:45,0:01:42,0.8268
2022,27,26,1,0:00:20,0:02:51,0:02:40,0.8462
2022,155,151,4,0:00:11,0:02:32,0:02:18,0.8961
2022,116,110,6,0:00:18,0:02:23,0:02:47,0.75
2022,117,111,6,0:00:18,0:02:43,0:02:06,0.7652
2022,113,105,8,0:00:31,0:02:37,0:03:40,0.5398
2022,107,101,6,0:00:23,0:02:44,0:03:11,0.7358
2022,146,141,5,0:00:25,0:02:22,0:02:46,0.6575
2022,29,26,3,0:00:09,0:02:37,0:01:50,0.8571
2022,231,228,3,0:00:15,0:02:09,0:03:26,0.8139
2022,239,215,24,0:00:23,0:02:36,0:04:35,0.6667
2022,174,154,20,0:00:29,0:02:40,0:05:08,0.6131
2022,168,163,5,0:00:21,0:02:49,0:02:45,0.7066
2022,135,128,7,0:00:18,0:02:36,0:05:30,0.7259
2022,122,113,9,0:00:30,0:02:49,0:03:40,0.6116
2022,13,12,1,0:00:24,0:02:45,0:01:12,0.6667
2022,20,18,2,0:00:23,0:02:43,0:02:44,0.7368
2022,152,141,11,0:00:22,0:02:41,0:04:29,0.7
2022,132,131,1,0:00:12,0:02:39,0:02:00,0.8702
2022,180,171,9,0:00:21,0:02:51,0:02:39,0.7191
2022,193,189,4,0:00:13,0:02:35,0:02:26,0.829
2022,245,236,9,0:00:13,0:02:44,0:02:20,0.8279
2022,35,34,1,0:00:11,0:02:11,0:01:44,0.8824
2022,198,190,8,0:00:12,0:02:38,0:01:22,0.8469
2022,47,47,0,0:00:06,0:02:09,0:00:57,0.9362
2022,187,186,1,0:00:07,0:02:30,0:02:45,0.9358
2022,57,54,3,0:00:07,0:02:37,0:00:55,0.9107
2022,169,162,7,0:00:09,0:02:39,0:01:50,0.8817
2022,337,316,21,0:00:23,0:02:13,0:05:17,0.7292
2022,44,43,1,0:00:09,0:02:35,0:01:50,0.8409
2022,210,206,4,0:00:12,0:02:39,0:02:32,0.8708
2022,190,186,4,0:00:17,0:02:22,0:04:53,0.8413
2022,190,182,8,0:00:10,0:02:40,0:01:38,0.8703
2022,169,168,1,0:00:11,0:02:25,0:01:48,0.8817
2022,52,50,2,0:00:06,0:02:34,0:00:58,0.9216
2022,144,137,7,0:00:14,0:02:36,0:02:56,0.7708
2022,36,36,0,0:00:15,0:02:53,0:01:41,0.8056
2022,155,148,7,0:00:14,0:02:26,0:03:23,0.8129
2022,159,154,5,0:00:16,0:02:41,0:02:12,0.7862
2022,115,110,5,0:00:14,0:02:28,0:02:17,0.8319
2022,186,173,13,0:00:19,0:02:39,0:02:44,0.7351
2022,167,157,10,0:00:23,0:02:32,0:02:49,0.6768
2022,146,142,4,0:00:22,0:02:42,0:01:59,0.669
2022,41,31,10,0:00:39,0:03:43,0:03:40,0.4878
2022,185,85,100,0:01:49,0:02:46,0:11:01,0.038
2022,149,83,66,0:01:38,0:02:18,0:10:06,0.0483
2022,180,115,65,0:01:04,0:02:33,0:12:50,0.2386
2022,173,144,29,0:00:38,0:03:00,0:05:32,0.4647
2022,176,158,18,0:00:20,0:02:33,0:05:15,0.7035
2022,147,120,27,0:00:46,0:02:39,0:04:16,0.3973
2022,84,77,7,0:00:17,0:02:07,0:04:30,0.7349
2022,325,78,247,0:03:13,0:03:01,0:17:27,0
2022,441,103,338,0:04:04,0:02:43,0:15:38,0.0023
2022,525,116,409,0:05:08,0:03:08,0:22:56,0
2022,610,201,409,0:03:13,0:02:52,0:19:15,0.0352
2022,427,282,145,0:01:02,0:02:49,0:14:42,0.2488
2022,378,331,47,0:00:43,0:02:37,0:05:30,0.4033
2022,80,67,13,0:00:38,0:03:12,0:05:30,0.4625
2022,356,320,36,0:00:34,0:02:52,0:05:30,0.5256
2022,409,355,54,0:00:44,0:02:55,0:04:21,0.397
2022,352,302,50,0:00:41,0:03:03,0:05:49,0.474
2022,282,239,43,0:00:39,0:03:06,0:08:26,0.5107
2022,429,390,39,0:00:38,0:02:41,0:03:40,0.4466
2022,310,285,25,0:00:33,0:02:45,0:04:12,0.5611
2022,102,94,8,0:00:29,0:02:40,0:02:48,0.6373
2022,335,297,38,0:00:39,0:02:33,0:03:42,0.4364
2022,313,291,22,0:00:26,0:02:25,0:03:42,0.6429
2022,251,240,11,0:00:24,0:02:42,0:02:45,0.672
2022,190,176,14,0:00:24,0:02:31,0:03:53,0.6772
2022,188,170,18,0:00:34,0:02:49,0:06:25,0.5323
2022,166,160,6,0:00:15,0:02:40,0:02:45,0.8182
2022,73,68,5,0:00:15,0:02:13,0:02:28,0.7887
2022,170,159,11,0:00:20,0:02:40,0:04:51,0.7321
2022,188,181,7,0:00:23,0:02:39,0:03:01,0.6828
2022,306,262,44,0:00:44,0:02:48,0:07:37,0.4633
2022,201,185,16,0:00:23,0:02:38,0:02:46,0.6734
2022,188,184,4,0:00:17,0:02:36,0:02:22,0.7926
2022,148,131,17,0:00:31,0:02:51,0:03:36,0.5306
2022,21,17,4,0:00:52,0:03:29,0:11:00,0.5238
2022,148,129,19,0:00:40,0:03:01,0:06:56,0.4552
2022,167,154,13,0:00:17,0:02:43,0:02:49,0.7349
2022,169,158,11,0:00:16,0:02:36,0:01:44,0.75
2022,175,163,12,0:00:22,0:02:37,0:02:18,0.711
2022,193,183,10,0:00:16,0:02:49,0:02:48,0.8021
2022,154,144,10,0:00:20,0:02:41,0:02:54,0.7351
2022,35,34,1,0:00:14,0:03:06,0:00:58,0.7714
2022,172,161,11,0:00:20,0:02:48,0:02:32,0.7209
2022,195,182,13,0:00:24,0:02:51,0:03:10,0.6684
2022,163,157,6,0:00:17,0:02:46,0:05:33,0.8221
2022,134,126,8,0:00:30,0:02:58,0:04:59,0.6357
2022,158,142,16,0:00:25,0:02:45,0:02:56,0.5935
2022,161,144,17,0:00:34,0:02:49,0:05:00,0.5313
2022,36,34,2,0:00:20,0:02:05,0:01:57,0.7222
2022,147,136,11,0:00:17,0:02:55,0:03:15,0.7671
2022,131,130,1,0:00:18,0:02:47,0:03:18,0.7692
2022,128,120,8,0:00:22,0:02:47,0:01:54,0.6825
2022,136,119,17,0:00:26,0:02:52,0:04:35,0.6015
2022,225,209,16,0:00:19,0:02:29,0:04:06,0.7602
2022,167,151,16,0:00:19,0:02:27,0:02:44,0.7333
2022,48,46,2,0:00:16,0:02:26,0:02:38,0.7872
2022,232,204,28,0:00:32,0:02:22,0:03:56,0.5541
2022,198,187,11,0:00:27,0:02:48,0:03:13,0.602
2022,171,163,8,0:00:19,0:02:41,0:02:48,0.6941
2022,180,173,7,0:00:31,0:02:49,0:08:13,0.7222
2022,192,175,17,0:00:26,0:03:01,0:03:40,0.6158
2022,194,180,14,0:00:25,0:02:50,0:04:03,0.6839
2022,37,27,10,0:00:35,0:02:53,0:02:58,0.5
2022,180,169,11,0:00:23,0:02:44,0:02:05,0.6798
2022,213,198,15,0:00:16,0:02:47,0:06:21,0.7725
2022,251,239,12,0:00:21,0:02:18,0:02:48,0.7177
2022,200,189,11,0:00:19,0:02:53,0:04:36,0.7626
2022,214,205,9,0:00:25,0:02:48,0:07:17,0.7196
2022,185,154,31,0:00:47,0:02:56,0:03:16,0.3591
2022,49,46,3,0:00:38,0:02:21,0:02:16,0.5208
2022,193,185,8,0:00:21,0:02:51,0:03:57,0.7579
2022,195,184,11,0:00:22,0:02:39,0:02:38,0.7
2022,211,195,16,0:00:34,0:02:51,0:04:31,0.5694
2022,200,190,10,0:00:15,0:02:56,0:03:06,0.8093
2022,48,47,1,0:00:15,0:03:13,0:02:58,0.8125
2022,164,159,5,0:00:20,0:02:51,0:04:47,0.7778
2022,43,42,1,0:00:14,0:02:32,0:02:34,0.8372
2022,236,223,13,0:00:26,0:02:46,0:03:38,0.6483
2022,270,262,8,0:00:15,0:02:36,0:02:08,0.8321
2022,304,262,42,0:00:34,0:02:56,0:07:01,0.5662
2022,286,270,16,0:00:20,0:02:48,0:03:06,0.7148
2022,317,284,33,0:00:30,0:02:48,0:08:16,0.6603
2022,471,396,75,0:00:59,0:02:41,0:05:29,0.308
2022,48,44,4,0:00:29,0:02:31,0:03:07,0.6596
2022,375,317,58,0:00:43,0:02:52,0:05:06,0.4087
2022,327,309,18,0:00:22,0:02:48,0:03:46,0.6821
2022,366,316,50,0:00:37,0:02:44,0:05:11,0.5374
2022,121,105,16,0:00:47,0:03:00,0:08:41,0.6
2022,287,266,21,0:00:34,0:03:06,0:04:08,0.5972
2022,298,277,21,0:00:39,0:03:08,0:03:35,0.5118
2022,70,56,14,0:00:46,0:03:23,0:05:08,0.4571
2022,287,255,32,0:00:40,0:03:30,0:04:09,0.4681
2022,298,259,39,0:00:30,0:03:14,0:07:15,0.5797
2022,347,317,30,0:00:30,0:03:11,0:05:52,0.5977
2022,414,356,58,0:00:43,0:03:27,0:15:32,0.4715
2022,406,362,44,0:00:37,0:03:02,0:05:17,0.5348
2022,366,322,44,0:00:35,0:03:03,0:11:12,0.5706
2022,68,64,4,0:00:14,0:02:58,0:02:04,0.8235
2022,350,320,30,0:00:37,0:03:13,0:05:39,0.5418
2022,437,352,85,0:00:52,0:03:01,0:09:33,0.4126
2022,484,438,46,0:00:45,0:02:57,0:05:47,0.4479
2022,405,368,37,0:00:35,0:03:09,0:05:41,0.581
2022,570,368,202,0:01:11,0:03:24,0:25:51,0.2354
2022,424,384,40,0:00:49,0:03:14,0:08:56,0.3952
2022,60,57,3,0:00:32,0:03:19,0:03:00,0.5593
2022,497,442,55,0:00:48,0:01:36,0:10:45,0.5758
2022,429,378,51,0:00:37,0:02:05,0:10:55,0.5529
2022,499,388,111,0:00:54,0:02:15,0:16:59,0.4776
2022,510,434,76,0:00:48,0:03:29,0:10:21,0.4219
2022,549,458,91,0:01:13,0:03:35,0:09:12,0.2907
2022,590,444,146,0:01:23,0:03:34,0:08:58,0.1903
2022,137,120,17,0:00:58,0:03:11,0:05:22,0.3309
2022,598,476,122,0:00:58,0:03:39,0:08:45,0.3203
2022,231,180,51,0:01:04,0:03:33,0:09:07,0.3378
2022,724,362,362,0:02:01,0:03:55,0:12:18,0.1166
2022,732,367,365,0:02:48,0:02:52,0:16:38,0.0809
2022,582,301,281,0:02:41,0:04:13,0:21:42,0.1208
2022,621,344,277,0:02:07,0:03:29,0:12:24,0.1447
2022,116,106,10,0:00:34,0:04:23,0:04:44,0.6293
2022,533,300,233,0:02:12,0:04:03,0:12:24,0.1255
2022,416,322,94,0:01:04,0:03:34,0:06:12,0.3859
2022,415,259,156,0:02:10,0:03:57,0:13:38,0.1789
2022,433,289,144,0:01:42,0:03:28,0:13:12,0.2295
2022,454,284,170,0:01:53,0:03:34,0:19:22,0.2444
2022,244,195,49,0:01:25,0:03:51,0:11:22,0.3667
2022,51,48,3,0:00:14,0:03:26,0:03:21,0.8431
2022,202,176,26,0:00:24,0:03:42,0:05:28,0.6716
2022,128,118,10,0:00:30,0:03:42,0:07:53,0.7402
2022,102,100,2,0:00:14,0:03:32,0:03:09,0.8529
2022,201,169,32,0:00:32,0:03:25,0:06:12,0.5808
2022,261,195,66,0:01:01,0:03:27,0:07:55,0.3798
2022,201,173,28,0:00:41,0:03:15,0:06:50,0.595
2022,64,61,3,0:00:09,0:03:15,0:02:23,0.9206
2022,200,168,32,0:00:51,0:03:23,0:06:46,0.4874
2022,158,148,10,0:00:30,0:03:17,0:04:08,0.5669
2022,174,155,19,0:00:26,0:03:01,0:05:10,0.6235
2022,67,64,3,0:00:26,0:03:31,0:04:58,0.7121
2022,24,23,1,0:00:23,0:02:50,0:02:01,0.75
2022,106,92,14,0:00:44,0:03:03,0:05:04,0.4563
2022,52,50,2,0:00:11,0:03:19,0:01:24,0.8846
2022,223,203,20,0:00:31,0:03:18,0:04:11,0.621
2022,274,233,41,0:00:48,0:03:27,0:05:10,0.3606
2022,280,263,17,0:00:23,0:03:13,0:03:50,0.6764
2022,534,468,66,0:00:30,0:02:46,0:04:39,0.5747
2022,315,300,15,0:00:24,0:03:11,0:02:50,0.7023
2022,122,113,9,0:00:20,0:02:58,0:02:19,0.7667
2022,63,60,3,0:00:21,0:02:51,0:02:52,0.7419
2022,402,368,34,0:00:32,0:03:07,0:03:06,0.5418
2022,413,370,43,0:00:29,0:03:10,0:03:22,0.5842
2022,389,346,43,0:00:36,0:03:21,0:05:10,0.4987
2022,495,308,187,0:01:31,0:03:25,0:16:35,0.1856
2022,712,340,372,0:02:00,0:03:26,0:16:25,0.1226
2022,1057,602,455,0:01:44,0:02:33,0:12:24,0.1149
2022,620,321,299,0:02:42,0:03:13,0:16:34,0.1087
2022,1575,871,704,0:01:32,0:02:33,0:22:45,0.1393
2022,1349,775,574,0:01:46,0:03:10,0:15:53,0.1216
2022,999,454,545,0:02:48,0:03:14,0:13:24,0.0407
2022,968,547,421,0:02:26,0:03:18,0:14:13,0.1171
2022,1066,453,613,0:05:04,0:03:39,0:22:37,0.0224
2022,788,633,155,0:01:13,0:03:23,0:12:26,0.2088
2022,252,213,39,0:00:53,0:03:31,0:08:17,0.4408
2022,842,625,217,0:01:11,0:03:10,0:14:28,0.2693
2022,847,722,125,0:00:54,0:03:04,0:08:05,0.3349
2022,800,615,185,0:01:07,0:03:25,0:07:24,0.2398
2022,1100,823,277,0:01:08,0:03:18,0:15:31,0.2965
2022,1242,909,333,0:01:23,0:03:04,0:11:11,0.19
2022,732,460,272,0:01:31,0:03:12,0:10:29,0.1792
2022,112,104,8,0:00:34,0:03:21,0:04:13,0.5636
2022,482,434,48,0:00:41,0:03:01,0:11:01,0.4744
2022,570,484,86,0:00:51,0:03:07,0:11:48,0.369
2022,490,398,92,0:00:50,0:03:17,0:21:44,0.361
2022,462,311,151,0:01:11,0:03:17,0:08:50,0.2634
2022,428,373,55,0:00:40,0:02:58,0:07:01,0.506
2022,393,312,81,0:01:02,0:03:16,0:08:16,0.314
2022,58,50,8,0:00:29,0:03:04,0:03:06,0.6724
2022,316,279,37,0:00:40,0:02:58,0:03:31,0.4416
2022,298,274,24,0:00:30,0:02:59,0:03:02,0.5578
2022,308,275,33,0:00:40,0:02:56,0:06:54,0.5163
2022,259,242,17,0:00:16,0:02:54,0:04:09,0.7826
2022,464,391,73,0:00:55,0:03:31,0:05:13,0.3545
2022,302,275,27,0:00:30,0:03:02,0:09:54,0.5604
2022,47,45,2,0:00:12,0:02:41,0:02:37,0.8511
2022,293,279,14,0:00:22,0:02:53,0:02:57,0.6747
2022,245,225,20,0:00:18,0:02:55,0:04:11,0.7355
2022,295,227,68,0:00:48,0:03:19,0:05:42,0.4479
2022,205,196,9,0:00:20,0:03:06,0:05:10,0.7366
2022,249,215,34,0:00:40,0:02:58,0:24:51,0.4609
2022,236,213,23,0:00:26,0:03:14,0:03:54,0.6336
2022,39,39,0,0:00:14,0:02:30,0:02:27,0.8718
2022,208,194,14,0:00:17,0:02:54,0:02:59,0.7696
2022,39,38,1,0:00:04,0:02:21,0:01:02,0.9487
2022,115,110,5,0:00:08,0:02:46,0:04:12,0.9043
2022,338,308,30,0:00:27,0:02:50,0:04:11,0.631
2022,404,320,84,0:00:45,0:02:58,0:11:53,0.5139
2022,436,393,43,0:00:26,0:02:51,0:06:13,0.6526
2022,73,72,1,0:00:07,0:02:46,0:01:43,0.9315
2022,521,492,29,0:00:17,0:02:45,0:03:23,0.7894
2022,648,564,84,0:00:27,0:02:46,0:05:25,0.6136
2022,729,592,137,0:00:55,0:02:53,0:07:29,0.3583
2022,1196,718,478,0:01:52,0:03:09,0:11:06,0.1462
2022,436,323,113,0:00:44,0:03:02,0:06:12,0.4375
2022,191,178,13,0:00:16,0:02:51,0:04:08,0.8053
2022,68,68,0,0:00:05,0:02:56,0:01:39,0.9853
2022,498,429,69,0:00:34,0:03:09,0:04:12,0.5071
2022,358,329,29,0:00:21,0:03:03,0:02:15,0.6695
2022,340,302,38,0:00:24,0:02:50,0:05:10,0.6567
2022,322,306,16,0:00:16,0:02:39,0:06:17,0.7774
2022,296,282,14,0:00:18,0:02:37,0:02:45,0.7653
2022,264,234,30,0:00:20,0:02:34,0:04:54,0.6988
2022,52,51,1,0:00:06,0:02:36,0:01:05,0.9412
2022,266,264,2,0:00:09,0:02:39,0:02:01,0.9098
2022,242,238,4,0:00:09,0:02:45,0:02:30,0.9046
2022,241,228,13,0:00:19,0:02:48,0:06:08,0.7958
2022,279,269,10,0:00:08,0:02:43,0:03:07,0.913
2022,73,72,1,0:00:08,0:03:04,0:02:10,0.9178
2022,226,218,8,0:00:08,0:02:54,0:02:47,0.9186
2022,43,42,1,0:00:11,0:02:38,0:01:17,0.8372
2022,311,255,56,0:00:45,0:02:55,0:04:50,0.4718
2022,251,210,41,0:00:26,0:02:54,0:09:18,0.6352
2022,339,313,26,0:00:12,0:02:02,0:06:41,0.8209
2022,323,261,62,0:00:41,0:02:57,0:09:27,0.5399
2022,289,265,24,0:00:11,0:03:00,0:05:42,0.8327
2022,310,281,29,0:00:15,0:02:41,0:02:57,0.7912
2022,33,31,2,0:00:14,0:02:53,0:02:07,0.8485
2022,346,318,28,0:00:12,0:02:36,0:03:32,0.8249
2022,325,285,40,0:00:32,0:02:45,0:09:39,0.6082
2022,627,504,123,0:00:37,0:03:20,0:19:42,0.5693
2022,905,631,274,0:01:23,0:03:42,0:12:04,0.2568
2022,1141,610,531,0:01:46,0:03:12,0:25:51,0.1455
2022,863,511,352,0:02:07,0:03:03,0:15:43,0.1213
2023,63,56,7,0:00:16,0:02:31,0:04:08,0.7097
2023,573,487,86,0:00:56,0:02:45,0:05:43,0.3499
2023,391,323,68,0:00:46,0:03:08,0:08:16,0.4271
2023,526,355,171,0:01:29,0:03:50,0:18:47,0.224
2023,343,309,34,0:00:39,0:03:24,0:05:10,0.4882
2023,401,346,55,0:00:41,0:03:13,0:05:10,0.4427
2023,281,239,42,0:00:41,0:03:07,0:03:20,0.4255
2023,46,39,7,0:00:11,0:03:09,0:04:09,0.8043
2023,357,323,34,0:00:32,0:03:08,0:07:14,0.6091
2023,280,255,25,0:00:34,0:03:02,0:03:31,0.529
2023,258,247,11,0:00:25,0:02:57,0:04:12,0.702
2023,282,255,27,0:00:18,0:02:47,0:04:09,0.7473
2023,253,240,13,0:00:18,0:02:41,0:06:11,0.752
2023,266,232,34,0:00:37,0:02:49,0:06:11,0.5759
2023,30,29,1,0:00:10,0:03:21,0:00:49,0.9
2023,258,230,28,0:00:33,0:03:01,0:04:14,0.5354
2023,293,282,11,0:00:23,0:02:39,0:02:38,0.7024
2023,377,341,36,0:00:20,0:02:21,0:03:09,0.6828
2023,196,182,14,0:00:28,0:02:37,0:02:54,0.6186
2023,192,173,19,0:00:33,0:02:44,0:06:39,0.6178
2023,185,178,7,0:00:17,0:02:46,0:03:09,0.7772
2023,27,25,2,0:00:18,0:02:09,0:03:07,0.7407
2023,222,214,8,0:00:18,0:02:57,0:06:12,0.7466
2023,217,198,19,0:00:09,0:02:43,0:02:57,0.8883
2023,204,197,7,0:00:17,0:02:40,0:03:50,0.797
2023,191,181,10,0:00:12,0:02:46,0:04:44,0.8723
2023,176,157,19,0:00:17,0:02:51,0:04:08,0.7353
2023,176,163,13,0:00:24,0:03:11,0:03:07,0.6416
2023,26,26,0,0:00:24,0:03:03,0:01:57,0.6923
2023,170,167,3,0:00:16,0:02:47,0:02:08,0.7941
2023,154,147,7,0:00:21,0:03:02,0:03:47,0.7516
2023,165,152,13,0:00:17,0:02:58,0:03:40,0.8075
2023,153,143,10,0:00:19,0:03:05,0:03:15,0.7763
2023,175,169,6,0:00:11,0:02:17,0:02:12,0.8563
2023,241,214,27,0:00:29,0:03:00,0:14:33,0.6623
2023,14,14,0,0:00:16,0:02:46,0:01:27,0.8571
2023,57,55,2,0:00:12,0:02:35,0:02:07,0.8596
2023,954,644,310,0:01:14,0:02:05,0:11:12,0.2633
2023,374,344,30,0:00:28,0:03:03,0:08:52,0.6185
2023,265,245,20,0:00:31,0:03:05,0:03:21,0.567
2023,222,205,17,0:00:20,0:03:12,0:02:10,0.7269
2023,203,192,11,0:00:27,0:03:04,0:04:07,0.6866
2023,33,31,2,0:00:29,0:02:15,0:05:43,0.7813
2023,220,195,25,0:00:28,0:02:45,0:03:06,0.5962
2023,185,177,8,0:00:16,0:02:33,0:03:08,0.8011
2023,203,172,31,0:00:34,0:02:53,0:05:06,0.5279
2023,218,193,25,0:00:34,0:02:58,0:07:34,0.6197
2023,204,194,10,0:00:16,0:02:52,0:03:06,0.8131
2023,242,211,31,0:00:44,0:02:57,0:06:08,0.477
2023,29,29,0,0:00:08,0:02:40,0:00:44,0.8966
2023,171,163,8,0:00:24,0:02:58,0:03:19,0.6923
2023,190,166,24,0:00:46,0:02:59,0:09:20,0.4225
2023,221,196,25,0:00:33,0:02:57,0:05:25,0.5367
2023,297,241,56,0:00:49,0:03:11,0:06:52,0.4483
2023,233,214,19,0:00:26,0:02:49,0:03:53,0.625
2023,198,191,7,0:00:14,0:03:01,0:02:09,0.8274
2023,15,15,0,0:00:04,0:03:19,0:00:14,1
2023,27,25,2,0:00:08,0:02:34,0:02:04,0.8889
2023,7,6,1,0:00:03,0:04:48,0:00:31,0.8571
2023,169,144,25,0:00:33,0:02:36,0:08:31,0.5636
2023,224,206,18,0:00:20,0:02:35,0:02:26,0.7072
2023,170,160,10,0:00:28,0:03:01,0:05:10,0.6235
2023,161,149,12,0:00:24,0:03:08,0:02:34,0.6813
2023,37,35,2,0:00:12,0:02:48,0:01:03,0.8056
2023,183,169,14,0:00:32,0:02:58,0:04:28,0.5989
2023,221,206,15,0:00:30,0:02:54,0:04:23,0.5818
2023,202,193,9,0:00:18,0:02:53,0:02:48,0.7538
2023,193,163,30,0:00:36,0:03:12,0:05:12,0.534
2023,201,196,5,0:00:10,0:02:43,0:02:32,0.89
2023,193,180,13,0:00:21,0:02:42,0:03:17,0.7316
2023,27,25,2,0:00:25,0:02:03,0:02:07,0.6667
2023,227,206,21,0:00:29,0:03:01,0:04:26,0.6667
2023,225,199,26,0:00:35,0:02:58,0:05:19,0.5268
2023,204,193,11,0:00:33,0:02:39,0:05:21,0.5882
2023,221,194,27,0:00:29,0:02:48,0:05:05,0.6073
2023,172,154,18,0:00:34,0:03:09,0:03:06,0.5417
2023,161,150,11,0:00:36,0:02:51,0:05:53,0.528
2023,17,14,3,0:00:47,0:03:08,0:02:52,0.4118
2023,168,145,23,0:00:38,0:02:57,0:04:08,0.5061
2023,160,142,18,0:00:33,0:02:44,0:09:18,0.5414
2023,185,159,26,0:00:41,0:02:56,0:05:43,0.427
2023,155,146,9,0:00:28,0:02:49,0:03:27,0.6516
2023,188,172,16,0:00:28,0:02:39,0:03:04,0.5978
2023,152,120,32,0:00:29,0:02:54,0:06:35,0.5306
2023,26,26,0,0:00:17,0:03:01,0:01:18,0.8077
2023,152,140,12,0:00:21,0:02:58,0:06:40,0.7067
2023,130,125,5,0:00:08,0:02:39,0:01:02,0.92
2023,191,187,4,0:00:18,0:02:33,0:02:53,0.8307
2023,254,227,27,0:00:33,0:02:57,0:04:35,0.5657
2023,213,188,25,0:00:30,0:02:52,0:05:10,0.5481
2023,176,151,25,0:00:32,0:02:45,0:06:12,0.5575
2023,61,59,2,0:00:16,0:01:31,0:03:06,0.8033
2023,166,154,12,0:00:28,0:02:56,0:03:16,0.6182
2023,191,172,19,0:00:21,0:02:40,0:03:23,0.7377
2023,171,157,14,0:00:19,0:02:34,0:02:07,0.7262
2023,153,124,29,0:00:50,0:03:04,0:06:01,0.4533
2023,183,158,25,0:00:33,0:02:52,0:05:10,0.5191
2023,14,14,0,0:00:15,0:03:43,0:01:32,0.8571
2023,18,18,0,0:00:03,0:02:56,0:00:06,1
2023,159,148,11,0:00:22,0:02:36,0:03:15,0.6943
2023,143,134,9,0:00:22,0:02:51,0:05:10,0.741
2023,195,175,20,0:00:29,0:02:47,0:04:11,0.6158
2023,194,150,44,0:00:37,0:02:47,0:04:17,0.4734
2023,390,362,28,0:00:31,0:02:50,0:05:46,0.5948
2023,238,205,33,0:00:29,0:02:18,0:05:10,0.6087
2023,29,28,1,0:00:09,0:02:28,0:01:05,0.8929
2023,30,29,1,0:00:19,0:02:30,0:02:31,0.8333
2023,287,273,14,0:00:16,0:02:20,0:03:06,0.79
2023,474,380,94,0:00:39,0:02:08,0:07:58,0.4742
2023,277,230,47,0:00:40,0:02:52,0:06:13,0.4618
2023,173,163,10,0:00:17,0:02:46,0:02:44,0.7719
2023,167,152,15,0:00:13,0:02:37,0:05:10,0.8415
2023,27,24,3,0:00:20,0:02:05,0:03:43,0.7692
2023,173,153,20,0:00:29,0:02:46,0:03:06,0.5799
2023,36,27,9,0:00:36,0:02:55,0:03:57,0.4167
2023,186,171,15,0:00:27,0:02:49,0:03:28,0.6448
2023,160,149,11,0:00:23,0:02:47,0:04:52,0.7405
2023,233,215,18,0:00:22,0:02:34,0:08:08,0.7412
2023,162,157,5,0:00:13,0:02:32,0:05:10,0.8272
2023,27,24,3,0:00:18,0:02:10,0:03:51,0.7037
2023,168,155,13,0:00:26,0:03:18,0:03:08,0.6488
2023,328,301,27,0:00:23,0:02:29,0:06:59,0.6791
2023,234,208,26,0:00:20,0:02:44,0:05:18,0.7225
2023,37,34,3,0:00:14,0:02:16,0:03:44,0.8378
2023,185,167,18,0:00:18,0:02:43,0:06:12,0.7351
2023,139,132,7,0:00:10,0:02:57,0:03:28,0.8832
2023,13,11,2,0:00:46,0:02:07,0:02:35,0.4167
2023,161,152,9,0:00:23,0:02:28,0:02:52,0.6962
2023,149,144,5,0:00:15,0:02:46,0:03:01,0.8311
2023,178,167,11,0:00:22,0:02:42,0:05:24,0.7486
2023,224,210,14,0:00:21,0:03:00,0:04:47,0.7252
2023,277,273,4,0:00:10,0:02:00,0:02:03,0.8974
2023,188,172,16,0:00:20,0:02:41,0:03:36,0.7219
2023,26,22,4,0:00:34,0:02:23,0:06:18,0.68
2023,177,167,10,0:00:35,0:02:56,0:03:15,0.5625
2023,149,144,5,0:00:28,0:02:47,0:03:48,0.6622
2023,147,147,0,0:00:11,0:02:51,0:02:03,0.8571
2023,140,134,6,0:00:19,0:02:44,0:08:19,0.7857
2023,177,163,14,0:00:19,0:02:35,0:07:16,0.7571
2023,169,169,0,0:00:09,0:02:45,0:01:05,0.8994
2023,26,21,5,0:00:27,0:02:28,0:02:04,0.48
2023,147,140,7,0:00:12,0:02:48,0:02:11,0.8552
2023,127,122,5,0:00:21,0:02:48,0:02:07,0.7087
2023,141,135,6,0:00:17,0:02:27,0:04:08,0.7801
2023,208,181,27,0:00:38,0:02:39,0:04:08,0.4902
2023,178,163,15,0:00:33,0:02:54,0:04:58,0.548
2023,198,190,8,0:00:25,0:02:32,0:02:22,0.6701
2023,21,17,4,0:00:44,0:03:31,0:04:37,0.4762
2023,171,161,10,0:00:16,0:02:35,0:06:14,0.8144
2023,200,196,4,0:00:09,0:02:51,0:02:01,0.9192
2023,166,157,9,0:00:24,0:02:40,0:01:54,0.6463
2023,230,217,13,0:00:27,0:02:39,0:02:03,0.5721
2023,174,168,6,0:00:24,0:02:57,0:02:54,0.6959
2023,240,185,55,0:01:00,0:03:02,0:05:00,0.2979
2023,35,27,8,0:00:48,0:02:56,0:03:53,0.4333
2023,198,179,19,0:00:27,0:02:41,0:09:40,0.601
2023,189,181,8,0:00:19,0:02:59,0:02:44,0.7143
2023,229,219,10,0:00:30,0:03:15,0:06:25,0.5921
2023,254,235,19,0:00:27,0:02:56,0:03:52,0.5968
2023,584,521,63,0:00:29,0:02:16,0:04:21,0.583
2023,564,551,13,0:00:12,0:01:40,0:01:46,0.8396
2023,150,149,1,0:00:10,0:01:40,0:02:11,0.8933
2023,521,499,22,0:00:23,0:01:36,0:03:04,0.7093
2023,330,309,21,0:00:21,0:03:19,0:06:32,0.6954
2023,298,288,10,0:00:13,0:03:20,0:04:03,0.8475
2023,294,287,7,0:00:14,0:03:28,0:03:19,0.8225
2023,261,253,8,0:00:10,0:03:03,0:05:48,0.8996
2023,223,210,13,0:00:16,0:03:07,0:05:23,0.8009
2023,59,58,1,0:00:21,0:03:41,0:03:12,0.7458
2023,340,327,13,0:00:21,0:01:55,0:03:46,0.7761
2023,287,280,7,0:00:13,0:03:05,0:01:56,0.8432
2023,269,257,12,0:00:16,0:03:04,0:03:49,0.8202
2023,270,261,9,0:00:12,0:03:06,0:04:29,0.8587
2023,285,273,12,0:00:12,0:03:14,0:02:53,0.8536
2023,251,229,22,0:00:22,0:02:59,0:03:06,0.7306
2023,47,47,0,0:00:13,0:03:03,0:01:29,0.8723
2023,233,225,8,0:00:13,0:03:02,0:01:57,0.8472
2023,257,248,9,0:00:14,0:03:14,0:03:42,0.834
2023,245,234,11,0:00:11,0:03:01,0:01:56,0.8595
2023,267,265,2,0:00:05,0:02:59,0:01:13,0.9736
2023,231,224,7,0:00:11,0:02:56,0:02:54,0.8658
2023,236,226,10,0:00:19,0:03:04,0:03:06,0.75
2023,81,78,3,0:00:11,0:02:57,0:00:58,0.8125
2023,281,273,8,0:00:11,0:03:02,0:03:21,0.8849
2023,399,387,12,0:00:11,0:02:51,0:02:25,0.8636
2023,291,287,4,0:00:11,0:02:36,0:03:38,0.8797
2023,290,281,9,0:00:07,0:03:03,0:01:00,0.9164
2023,230,227,3,0:00:08,0:03:06,0:01:12,0.9167
2023,236,216,20,0:00:17,0:03:09,0:02:54,0.7069
2023,45,44,1,0:00:05,0:02:45,0:01:56,0.9333
2023,249,238,11,0:00:11,0:02:42,0:01:58,0.8653
2023,350,328,22,0:00:28,0:02:31,0:02:28,0.5826
2023,361,306,55,0:00:27,0:02:26,0:06:41,0.6017
2023,262,256,6,0:00:13,0:02:50,0:02:54,0.8615
2023,302,288,14,0:00:21,0:02:56,0:02:59,0.711
2023,299,268,31,0:00:28,0:02:49,0:02:58,0.5541
2023,50,49,1,0:00:24,0:02:55,0:02:08,0.76
2023,285,273,12,0:00:21,0:02:49,0:03:30,0.7616
2023,77,75,2,0:00:09,0:02:43,0:02:10,0.9211
2023,332,321,11,0:00:17,0:02:58,0:03:34,0.8066
2023,282,266,16,0:00:22,0:03:10,0:08:12,0.7429
2023,256,248,8,0:00:14,0:03:00,0:03:52,0.8235
2023,177,176,1,0:00:12,0:02:37,0:01:45,0.8352
2023,27,24,3,0:00:13,0:02:15,0:01:08,0.7407
2023,307,305,2,0:00:09,0:03:01,0:01:42,0.918
2023,587,577,10,0:00:10,0:02:08,0:01:56,0.9194
2023,270,265,5,0:00:07,0:02:44,0:01:56,0.9179
2023,307,297,10,0:00:14,0:02:59,0:02:55,0.8224
2023,242,238,4,0:00:06,0:02:42,0:01:55,0.9463
2023,194,182,12,0:00:12,0:02:57,0:01:36,0.8115
2023,21,21,0,0:00:12,0:03:07,0:01:34,0.9048
2023,291,288,3,0:00:07,0:02:46,0:01:24,0.9379
2023,516,479,37,0:00:26,0:02:40,0:03:31,0.638
2023,452,447,5,0:00:06,0:02:04,0:03:52,0.9444
2023,375,375,0,0:00:05,0:02:13,0:01:05,0.9653
2023,306,287,19,0:00:19,0:02:15,0:04:50,0.7632
2023,241,235,6,0:00:15,0:02:40,0:01:57,0.8033
2023,34,34,0,0:00:18,0:03:01,0:02:08,0.8529
2023,248,238,10,0:00:19,0:02:43,0:04:33,0.7409
2023,323,307,16,0:00:13,0:02:42,0:03:28,0.827
2023,260,257,3,0:00:10,0:02:29,0:01:42,0.9112
2023,316,311,5,0:00:10,0:02:41,0:02:54,0.8754
2023,60,59,1,0:00:03,0:02:41,0:01:55,0.9833
2023,267,251,16,0:00:19,0:02:27,0:07:44,0.7556
2023,30,29,1,0:00:08,0:02:00,0:00:46,0.931
2023,247,238,9,0:00:13,0:02:35,0:02:54,0.8333
2023,376,365,11,0:00:15,0:03:00,0:03:30,0.8177
2023,316,306,10,0:00:13,0:02:55,0:01:58,0.828
2023,310,304,6,0:00:07,0:02:51,0:01:40,0.9216
2023,340,327,13,0:00:23,0:02:55,0:02:34,0.7134
2023,306,289,17,0:00:24,0:02:43,0:05:04,0.6974
2023,40,40,0,0:00:05,0:02:46,0:00:51,0.975
2023,378,370,8,0:00:11,0:02:52,0:02:36,0.867
2023,424,416,8,0:00:14,0:02:54,0:03:41,0.8389
2023,356,353,3,0:00:05,0:02:48,0:01:04,0.9717
2023,320,308,12,0:00:10,0:02:33,0:03:24,0.8899
2023,351,341,10,0:00:11,0:02:50,0:01:49,0.8625
2023,85,83,2,0:00:13,0:02:47,0:03:44,0.8588
2023,44,43,1,0:00:09,0:02:33,0:03:52,0.8409
2023,388,363,25,0:00:19,0:03:06,0:02:54,0.752
2023,283,280,3,0:00:06,0:03:05,0:01:49,0.9573
2023,241,238,3,0:00:05,0:02:55,0:03:16,0.9667
2023,280,273,7,0:00:09,0:02:46,0:03:38,0.8821
2023,294,273,21,0:00:26,0:03:16,0:02:44,0.6177
2023,290,246,44,0:00:27,0:03:04,0:04:44,0.6386
2023,32,32,0,0:00:06,0:02:43,0:01:10,0.9688
2023,270,263,7,0:00:12,0:02:52,0:02:00,0.8545
2023,212,208,4,0:00:08,0:02:43,0:02:34,0.91
2023,246,238,8,0:00:07,0:02:53,0:03:48,0.9184
2023,194,190,4,0:00:08,0:02:43,0:03:34,0.9278
2023,179,176,3,0:00:06,0:02:44,0:01:43,0.9605
2023,67,65,2,0:00:09,0:02:36,0:01:59,0.8955
2023,27,27,0,0:00:09,0:02:27,0:01:33,0.8889
2023,190,183,7,0:00:09,0:02:38,0:02:54,0.8783
2023,213,205,8,0:00:10,0:02:38,0:05:02,0.8815
2023,208,205,3,0:00:04,0:02:36,0:02:53,0.9709
2023,166,165,1,0:00:08,0:02:41,0:03:31,0.9277
2023,169,161,8,0:00:18,0:02:52,0:03:37,0.7396
2023,175,167,8,0:00:10,0:02:29,0:03:52,0.8629
2023,43,43,0,0:00:04,0:02:42,0:00:29,1
2023,24,24,0,0:00:03,0:02:46,0:00:03,1
2023,26,26,0,0:00:05,0:02:52,0:00:58,0.9231
2023,42,41,1,0:00:03,0:02:41,0:00:03,1
2023,37,36,1,0:00:05,0:02:24,0:04:50,0.9459
2023,60,60,0,0:00:05,0:03:07,0:01:01,0.9667
2023,82,81,1,0:00:03,0:02:24,0:00:58,0.9756
2023,31,31,0,0:00:06,0:02:20,0:01:01,0.9355
2023,178,171,7,0:00:16,0:02:43,0:02:06,0.7614
2023,183,175,8,0:00:13,0:02:27,0:04:38,0.8556
2023,39,37,2,0:00:03,0:02:53,0:00:58,0.9737
2023,170,167,3,0:00:12,0:02:24,0:02:50,0.8529
2023,180,168,12,0:00:12,0:02:46,0:04:29,0.8315
2023,24,24,0,0:00:04,0:02:36,0:00:21,1
2023,7,7,0,0:00:33,0:02:39,0:01:33,0.4286
2023,181,181,0,0:00:12,0:02:47,0:01:29,0.8785
2023,209,206,3,0:00:05,0:02:42,0:00:58,0.9517
2023,180,179,1,0:00:04,0:02:28,0:01:02,0.9721
2023,221,203,18,0:00:12,0:02:43,0:02:55,0.8732
2023,254,248,6,0:00:10,0:02:48,0:03:07,0.9087
2023,627,577,50,0:00:41,0:02:39,0:05:20,0.4781
2023,167,159,8,0:00:18,0:03:10,0:03:55,0.7605
2023,599,554,45,0:00:25,0:02:35,0:04:50,0.6356
2023,304,300,4,0:00:07,0:02:35,0:02:55,0.9241
2023,267,260,7,0:00:08,0:02:56,0:01:54,0.9091
2023,286,281,5,0:00:11,0:02:40,0:02:54,0.8697
2023,196,192,4,0:00:13,0:02:43,0:02:06,0.8564
2023,191,189,2,0:00:11,0:03:00,0:02:34,0.8842
2023,60,60,0,0:00:06,0:01:58,0:00:59,0.9667
2023,215,207,8,0:00:10,0:02:40,0:01:44,0.9043
2023,221,213,8,0:00:08,0:02:35,0:01:47,0.9045
2023,201,193,8,0:00:03,0:02:46,0:00:58,0.9845
2023,205,202,3,0:00:05,0:02:48,0:01:09,0.9606
2023,201,194,7,0:00:14,0:02:44,0:02:29,0.8426
2023,140,132,8,0:00:07,0:01:51,0:01:56,0.9248
2023,29,28,1,0:00:13,0:03:09,0:01:47,0.8276
2023,398,372,26,0:00:21,0:02:51,0:04:13,0.7252
2023,255,249,6,0:00:15,0:03:01,0:02:09,0.8333
2023,283,278,5,0:00:17,0:02:38,0:01:59,0.7957
2023,230,222,8,0:00:21,0:02:46,0:02:45,0.7225
2023,185,183,2,0:00:10,0:03:15,0:01:20,0.8973
2023,197,194,3,0:00:13,0:02:49,0:02:01,0.8265
2023,15,14,1,0:00:12,0:03:14,0:01:48,0.8667
2023,230,228,2,0:00:07,0:02:47,0:01:01,0.9389
2023,232,224,8,0:00:12,0:02:51,0:01:34,0.8646
2023,237,231,6,0:00:11,0:03:01,0:01:59,0.8771
2023,42,39,3,0:00:17,0:02:51,0:01:40,0.7857
2023,215,211,4,0:00:06,0:03:06,0:02:54,0.9481
2023,153,152,1,0:00:04,0:02:35,0:00:55,0.9869
2023,39,39,0,0:00:14,0:03:42,0:01:37,0.8462
2023,334,322,12,0:00:17,0:02:56,0:02:18,0.7713
2023,236,225,11,0:00:13,0:02:53,0:01:56,0.8509
2023,186,182,4,0:00:08,0:02:38,0:02:10,0.9511
2023,202,197,5,0:00:13,0:02:33,0:01:56,0.87
2023,185,182,3,0:00:08,0:02:49,0:02:33,0.9027
2023,38,38,0,0:00:04,0:03:26,0:00:57,0.9737
2023,25,24,1,0:00:03,0:02:44,0:00:46,0.96
2023,203,195,8,0:00:08,0:02:38,0:08:34,0.8856
2023,296,292,4,0:00:04,0:02:40,0:00:58,0.9863
2023,233,223,10,0:00:09,0:02:47,0:01:46,0.8783
2023,198,194,4,0:00:08,0:02:42,0:01:43,0.9179
2023,181,179,2,0:00:04,0:02:39,0:00:48,0.9944
2023,166,162,4,0:00:06,0:02:39,0:01:01,0.9387
2023,19,19,0,0:00:03,0:02:27,0:00:03,1
2023,196,181,15,0:00:14,0:02:37,0:02:36,0.7813
2023,176,172,4,0:00:16,0:02:30,0:02:56,0.7943
2023,221,209,12,0:00:12,0:02:42,0:02:50,0.8387
2023,196,191,5,0:00:14,0:02:51,0:05:54,0.8601
2023,211,202,9,0:00:15,0:02:46,0:02:54,0.7933
2023,201,194,7,0:00:16,0:02:49,0:03:28,0.8141
2023,23,22,1,0:00:10,0:03:02,0:01:02,0.8261
2023,225,210,15,0:00:10,0:02:37,0:03:37,0.8591
2023,202,195,7,0:00:11,0:02:47,0:01:52,0.868
2023,191,184,7,0:00:07,0:02:50,0:01:56,0.9255
2023,212,209,3,0:00:10,0:02:51,0:01:45,0.891
2023,210,203,7,0:00:12,0:03:22,0:03:52,0.8524
2023,167,159,8,0:00:16,0:03:16,0:02:42,0.8303
2023,12,11,1,0:00:03,0:02:12,0:00:58,0.9167
